####################
#F%               C#
############D#######
#           *      #
####################